R 1280 720

NO ./resources/texture/environment/wall.png
SO ./resources/texture/environment/wall.png
WE ./resources/texture/environment/wall.png
EA ./resources/texture/environment/wall.png

F ./resources/texture/environment/floor.png
C ./resources/texture/environment/skybox.png

S_BUSH ./resources/texture/environment/bush.png
S_MASTERBALL ./resources/texture/environment/masterball.png
S_SNORLAX ./resources/texture/environment/snorlax.png

POKEMON Victini victini.png
POKEMON Zekrom zekrom.png

11111111111111111111111111111
        1111111111111111111111111
        1004000000110000200000001
        101103000110000020N000001
        1001000000000000200000001
111111111011000001110000000000001
100000000011000001110111111111111
11110111111111011100000010001
1111011111111 011101210010001
11000000110101011100000010001
10000200000000001100000010001
10000000000000001101010010001
1100000111010101111101111000111
11110111 1110101 101111010001
11111111 1111111 111111111111