R 1280 720

NO ../resources/texture/wall.png
SO ../resources/texture/wall.png
WE ../resources/texture/wall.png
EA ../resources/texture/wall.png

F ../resources/texture/floor.png
C ../resources/texture/skybox.png

S_BUSH ../resources/texture/bush.png
S_MN ../resources/texture/MN-cut.png

POKEMON Victini victini.png

11111111111111111111111111111
        1111111111111111111111111
        1000000003110000000000001
        101100000111000020N020001
        1001000000000000002020001
111111111011000001110000000000001
100000000011000001110111111111111
11110111111111011100000010001
1111011111111 011101010010001
11000000110101011100000010001
10022220000000001100000010001
10000000000000001101010010001
1100000111010101111101111000111
11110111 1110101 101111010001
11111111 1111111 111111111111